----------------------------------------
----XXXX------X------X----X----XXXXXXX--
---X----X-----V------V----V-------V-----
--X------X----V------V----V-------V-----
--X------X----V------V----V-------V-----
--X----X-X----V------V----V-------V-----
---X----X------X----X-----V-------V-----
----XXXX-X------XXXX------V-------V-----
----------X-----------------------------
XXXXXXXXXXXXXXXXXXXXXXXXXXXXXXXXXXXXXXXX