----------------------------------------
----------------------------------------
-XXX---XXXX---XXXX--XX----X--XXXXX--XXXX
X---X--V---X--V-----V-X---V----V----V---
V------VXXX---VXX---V--X--V----V----VXXX
V---X--V-V----V-----V-X---V----V-------V
-XXX---V--X---VXXX--VX----V----V----XXXV
----------------------------------------
----------------------------------------
XXXXXXXXXXXXXXXXXXXXXXXXXXXXXXXXXXXXXXXX