----------------------------------------
----------------------------------------
X------XXXXXX------X------XXXX---XX----X
V------V----------X-X-----V---X--V-X---V
V------VXXX------XVXVX----VXXX---V--X--V
V------V--------X-----X---V--V---V---X-V
VXXXX--VXXXXX--X-------X--V---X--V----XV
----------------------------------------
----------------------------------------
XXXXXXXXXXXXXXXXXXXXXXXXXXXXXXXXXXXXXXXX