XXXX-----X--------------X------X-------X
V---X----V-------------X-X------X-----X-
V----X---V------------X---X------X---X--
V---X----V-----------X-----X------X-X---
VXXX-----V----------XVXXXXXVX------X----
V--------V---------X---------X-----V----
V--------V--------X-----------X----V----
V--------VXXXXX---X-----------X----V----
----------------------------------------
XXXXXXXXXXXXXXXXXXXXXXXXXXXXXXXXXXXXXXXX